ORO	= "countries/Oromia.txt"
QAF	= "countries/Qafara.txt"
NUE	= "countries/Nuer.txt"
SIB = "countries/Siberia.txt"
ARC = "countries/ARC.txt"
CYR = "countries/Cyrenaica.txt"
GRN = "countries/Greenland.txt"
QUE = "countries/Quebec.txt"
PAD = "countries/Padania.txt"
PAT = "countries/Patagonia.txt"
PNM = "countries/Panem.txt"
ONE = "countries/Disc1.txt"
DOS = "countries/Disc2.txt"
TRE = "countries/Disc3.txt"
CUA = "countries/Disc4.txt"
SEI = "countries/Disc6.txt"
SIT = "countries/Disc7.txt"
OCH = "countries/Disc8.txt"
URA = "countries/Ural.txt"
KRP = "countries/Karpatska.txt"
AMU = "countries/Amur.txt"
KAS = "countries/Kashmir.txt"
HAZ = "countries/Hazaristan.txt"
KHS = "countries/Khorasan.txt"
TAB = "countries/Tabaristan.txt"
AZS = "countries/Azeristan.txt"
KRN = "countries/Karen.txt"
SHN = "countries/Shan.txt"
NAG = "countries/Nagalim.txt"
ASM = "countries/Assam.txt"
MNP = "countries/Manipur.txt"
ZOG = "countries/Zogam.txt"
RKH = "countries/Rakhine.txt"
CSU = "countries/Jeju.txt"
UTT = "countries/Uttarakhand.txt"
HIM = "countries/Himachal.txt"
BIH = "countries/Bihar.txt"
BHR = "countries/Bharat.txt"
BNG = "countries/WestBengal.txt"
ODS = "countries/Odisha.txt"
NAX = "countries/Naxal.txt"
CPI = "countries/CommieIndia.txt"
ADH = "countries/Andhra.txt"
TAM = "countries/Tamilakam.txt"
TLG = "countries/Telangana.txt"
KRT = "countries/Karnataka.txt"
KRL = "countries/Kerala.txt"
MAH = "countries/Maharashtra.txt"
GUJ = "countries/Gujerat.txt"
SIN = "countries/Sindh.txt"
PUN = "countries/Punjab.txt"
BLC = "countries/Balochistan.txt"
KAV = "countries/Kavithan.txt"
BGV = "countries/BrasilianGovernment.txt"
LEG = "countries/LegiaoSertao.txt"
GRP = "countries/RepublicanoProvis√≥rio.txt"
LAM = "countries/Lamentadores.txt"
DNG = "countries/Dongbei.txt"
IMO = "countries/InnerMongolia.txt"
XIN = "countries/Xinjiang.txt"
GAN = "countries/Gansu.txt"
SHA = "countries/Shandong.txt"
QIN = "countries/Qinghai.txt"
SIC = "countries/Sichuan.txt"
CHO = "countries/Chonqing.txt"
YAN = "countries/Yangtze.txt"
ZHE = "countries/Zhejiang.txt"
FUJ = "countries/Fujian.txt"
GUI = "countries/Guizhou.txt"
TAI = "countries/Taiwan.txt"
GND = "countries/Guangdong.txt"
GNX = "countries/Guangxi.txt"
HAN = "countries/Hainan.txt"
YNN = "countries/Yunnan.txt"
KAC = "countries/Kachin.txt"
WAA = "countries/Wa.txt"